# added postag entries
#-------------------------------------------------------------------------------
# Do not add words here, but report them to languagetool@taaltik.nl
#-------------------------------------------------------------------------------
drone	drone	ZNW:EKV:DE_
tegelijkertijd	tegelijkertijd	BYW
Boogschutter	Boogschutter	ZNW:EKV:DE_
Luilekkerland	Luilekkerland	ZNW:EKV:HET
informatie-uitwisseling	informatie-uitwisseling	ZNW:EKV:DE_
Mongool	Mongool	ZNW:EKV:DE_
zakenduo	zakenduo	ZNW:EKV
zakenduo's	zakenduo	ZNW:MRV:DE_
joik	joik	ZNW:EKV:DE_
aanvalsdrone	aanvalsdrone	ZNW:EKV:DE_
Houthi	Houthi	ZNW:EKV:DE_
Houthi's	Houthi	ZNW:MRV:DE_
Houthirebellen	Houthirebel	ZNW:MRV:DE_
tepanyaki	tepanyaki	ZNW:EKV
yakitori	yakitori	ZNW:EKV
informatie-uitwisselingen	informatie-uitwisseling	ZNW:MRV:DE_
Mongolen	Mongool	ZNW:MRV:DE_
Mongools	Mongools	BNW:STL:ONV
Mongoolse	Mongools	BNW:STL:VRB
Mongoolse	Mongoolse	ZNW:EKV:DE_
wandelwegjes	wandelweg	ZNW:MRV:VRK:DE_
opbrengstgerichter	opbrengstgericht	BNW:VGR:ONV
terugrij	terugrijden	WKW:TGW:1EP
kunststof	kunststof	BNW:STF
