# deleted postag entries
#-------------------------------------------------------------------------------
# Do not add words here, but report them to languagetool@taaltik.nl
#-------------------------------------------------------------------------------
Afstandswijzigingen	Afstandswijzigingen	VLG:BHL
Anansitori	Anansitori	VLG:BHL
Aquariumafmeting	Aquariumafmeting	VLG:BHL
Art	Art	VLG:BHL
Belga	Belga	VLG:BHL
Beoordelingsbeslissingen	Beoordelingsbeslissingen	VLG:BHL
Biezenmatje	Biezenmatje	VLG:BHL
Blankers	Blankers	VLG:BHL
Bondsdaglid	Bondsdaglid	VLG:BHL
Bondsdagverkiezing	Bondsdagverkiezing	VLG:BHL
Brinkroute	Brinkroute	VLG:BHL
Broedvogelonderzoeken	Broedvogelonderzoeken	VLG:BHL
Calculatieformulieren	Calculatieformulieren	VLG:BHL
Candy	Candy	VLG:BHL
Carnavalsverplichting	Carnavalsverplichting	VLG:BHL
Clements	Clements	VLG:BHL
Cuppen	Cuppen	VLG:BHL
Databasefabrikanten	Databasefabrikanten	VLG:BHL
Dieseltrekker	Dieseltrekker	VLG:BHL
Dispensatieformulieren	Dispensatieformulieren	VLG:BHL
Dorpsraadsvergaderingen	Dorpsraadsvergaderingen	VLG:BHL
Dur	Dur	VLG:BHL
Examenvergaderingen	Examenvergaderingen	VLG:BHL
Galilea	Galilea	VLG:BHL
Graszaadleveranciers	Graszaadleveranciers	VLG:BHL
Handelsplein	Handelsplein	VLG:BHL
Havenzaak	Havenzaak	VLG:BHL
Hondenvriendschap	Hondenvriendschap	VLG:BHL
Imme	Imme	VLG:BHL
Iva	Iva	VLG:BHL
Jodenvervolgingen	Jodenvervolgingen	VLG:BHL
Kabouterliefhebbers	Kabouterliefhebbers	VLG:BHL
Klantbudget	Klantbudget	VLG:BHL
Licentieformulieren	Licentieformulieren	VLG:BHL
Luchtfilterfabrikant	Luchtfilterfabrikant	VLG:BHL
Lucky's	Lucky's	VLG:BHL
Meevis	Meevis	VLG:BHL
Micromodule	Micromodule	VLG:BHL
Middelbreedte	Middelbreedte	VLG:BHL
Molendijken	Molendijken	VLG:BHL
Naarders	Naarders	VLG:BHL
Netflix	Netflix	VLG:BHL
Offertemodules	Offertemodules	VLG:BHL
Operacentrum	Operacentrum	VLG:BHL
Pakketbehandelingen	Pakketbehandelingen	VLG:BHL
Partneractiviteit	Partneractiviteit	VLG:BHL
Promotieschema's	Promotieschema's	VLG:BHL
Rider	Rider	VLG:BHL
Schakeleigenschap	Schakeleigenschap	VLG:BHL
Schimmer	Schimmer	UNSPECIFIED
Schimmert	Schimmert	VLG:BHL
Servicekwestie	Servicekwestie	VLG:BHL
Staten-Generaal	Staten-Generaal	VLG:BHL
Steegs	Steegs	VLG:BHL
Steg	Steg	VLG:BHL
Strijdbewijs	Strijdbewijs	VLG:BHL
Talentontwikkelprogramma's	Talentontwikkelprogramma's	VLG:BHL
Textielwasmiddel	Textielwasmiddel	VLG:BHL
Ties	Ties	VLG:BHL
Tuinbouwprijs	Tuinbouwprijs	VLG:BHL
Vangnetuitkeringen	Vangnetuitkeringen	VLG:BHL
Ventilatorfabrikanten	Ventilatorfabrikanten	VLG:BHL
Verenigingsdossiers	Verenigingsdossiers	VLG:BHL
Wade	Wade	VLG:BHL
Warmtefase	Warmtefase	VLG:BHL
Waterschapsvergadering	Waterschapsvergadering	VLG:BHL
Werdt	Werdt	VLG:BHL
Wons	Wons	VLG:BHL
Zagt	Zagt	VLG:BHL
afboer	afboer	ZNW:EKV
apacheje	apache	ZNW:EKV:VRK:HET
apachejes	apache	ZNW:MRV:VRK:DE_
apachetje	apache	ZNW:EKV:VRK:HET
apachetjes	apache	ZNW:MRV:VRK:DE_
begrazingetje	begrazing	ZNW:EKV:VRK:HET
begrazingetjes	begrazing	ZNW:MRV:VRK:DE_
begrazinkje	begrazing	ZNW:EKV:VRK:HET
begrazinkjes	begrazing	ZNW:MRV:VRK:DE_
conflictmineraal	conflictmineraal	ZNW:EKV
contra-argument	contra-argument	ZNW:EKV
curlingen	curling	ZNW:MRV:DE_
curlingetje	curling	ZNW:EKV:VRK:HET
curlingetjes	curling	ZNW:MRV:VRK:DE_
curlinkje	curling	ZNW:EKV:VRK:HET
curlinkjes	curling	ZNW:MRV:VRK:DE_
droogtetje	droogte	ZNW:EKV:VRK:HET
droogtetjes	droogte	ZNW:MRV:VRK:DE_
drukkers-uitgevers	drukkers-uitgevers	ZNW:MRV:DE_
eerstes	een	GET:NMR:MRV:DE_
fondsenwervende	fondsenwervende	BNW:STL:VRB
gekeuterd	gekeuterd	UNSPECIFIED
gelieften	gelieven	WKW:VLT:INF
gevangenen	vangen	WKW:VTD:MRV:DE_
infomeer	infomeer	ZNW:EKV
keuteren	keuteren	UNSPECIFIED
liberaal-conservatief	liberaal-conservatief	UNSPECIFIED
matgoud	matgoud	BNW:STL:ONV
matgouds	matgoud	BNW:STL:IET
moogt	moogt	UNSPECIFIED
ondersteuningsnood	ondersteuningsnood	BNW:STL:VRB
ontvonk	ontvonk	ZNW:EKV:DE_
ontvonken	ontvonk	ZNW:MRV:DE_
ontvonkt	ontvonkt	UNSPECIFIED
ontvonkte	ontvonkte	UNSPECIFIED
patroon	patroon	ZNW:EKV
rotte	rotte	ZNW:EKV
skif	skiffen	WKW:TGW:INF
stofferingetje	stoffering	ZNW:EKV:VRK:HET
stofferingetjes	stoffering	ZNW:MRV:VRK:DE_
stofferinkje	stoffering	ZNW:EKV:VRK:HET
stofferinkjes	stoffering	ZNW:MRV:VRK:DE_
tafia	tafia	UNSPECIFIED
tietjes	ti	ZNW:MRV:VRK:DE_
uitbuitingetje	uitbuiting	ZNW:EKV:VRK:HET
uitbuitingetjes	uitbuiting	ZNW:MRV:VRK:DE_
uitbuitinkje	uitbuiting	ZNW:EKV:VRK:HET
uitbuitinkjes	uitbuiting	ZNW:MRV:VRK:DE_
verbeurdverklaren	verbeurdverklaren	UNSPECIFIED
verkerfd	verkerven	WKW:VTD:ONV
verkerfde	verkerven	WKW:VTD:VRB
zijt	zijt	UNSPECIFIED
